{
    "tileset" : "tileset.json",
    "width" : 8,
    "height" : 8,
    "twidth" : 64,
    "theight" : 64,
    "tilemap" : [
        0, 0, 0, 0, 0, 0, 0, 0, 
        0, 0, 0, 1, 0, 0, 0, 0,
        0, 0, 1, 1, 1, 0, 0, 0,
        0, 1, 0, 1, 0, 1, 0, 0,
        0, 0, 0, 1, 0, 0, 0, 0,
        0,-1,-1, 1, 0, 0, 0, 0,
        0,-1,-1, 1, 0, 0, 0, 0,
        0, 0, 0, 0, 0, 0, 0, 0
    ]
}
